#####################################################
#@..#...............................................#
#...........#...........+...........................#
#####.......#.......................................#
#.......#####.......................................#
#...................................................#
#...................................................#
#...................................................#
#...................................................#
#........................g..........................#
#...................................................#
#...................................................#
#...................................................#
#...................................................#
#...................................................#
#...................................................#
#................................................g..#
#####################################################